15 19
+--------+--------+
|B.......|.......B|
|.+.+--+.+.+--+.+.|
|.................|
|.+.+.+--+--+.+.+.|
|...|....|....|...|
|.+.+--+.+.+--+.+.|
|.|.|.F.F.F.F.|.|.|
+.+.+.+--+--+.+.+.+
|........@........|
+-+.+.+--+--+.+.+-+
|...|....|....|...|
|.--+--+.+.+--+--.|
|B...............B|
+-----------------+
