9 19
+-----------------+
|F...|.......|...F|
|..|...|.|.|...|..|
|-.|.---.|.---.|.-|
|........@........|
|-.|.---.|.---.|.-|
|..|...|.|.|...|..|
|F...|.......|...F|
+-----------------+
