9 19
+-----------------+
|F...|.......|...F|
|.-|.B.|.|.|...|-.|
|..|.---.|.---.|..|
|-.......@.......-|
|..|.---.|.---.|..|
|.-|...|.|.|...|-.|
|F...|.......|...F|
+-----------------+
